111111111
100000001
1100C0001
1P10000E1
1100C0001
111111111