1111111111
1000010001
100000C001
1000000011
100P000111
10000001C1
1010000101
10E0000001
1111111111