1111111111
1000010001
100000C001
1000000011
100P000001
100000C001
1111000001
10E0000001
1111111111