1111111111
101000E001
1000001001
1010000001
1100P00001
10100000C1
1100001001
1010000001
1111111111